Kept verb forms for language: eng

Kept verb forms for language: spa

Kept verb forms for language: deu

Kept verb forms for language: ita

Spanish First Singular (A): Conjugación del verbo mandonear en presente: Yo mandoneo
Spanish Second Singular (A): Conjugación del verbo mandonear en presente: Tú mandoneas
Italian First Singular (A): Coniugazione del verbo disinfettare al presente: Io disinfetto
Italian Second Singular (A): Coniugazione del verbo disinfettare al presente: Tu disinfetti
German First Singular (A): Konjugation des Verbs annektieren im Präsens: Ich annektiere
German Second Singular (A): Konjugation des Verbs annektieren im Präsens: Du annektierst
English First Singular (A): Conjugation of the verb microtome in present tense: I microtome
English Second Singular (A): Conjugation of the verb microtome in present tense: You microtome
Spanish First Singular (B): Conjugación del verbo mandonear en presente en Español: Yo mandoneo
Spanish Second Singular (B): Conjugación del verbo mandonear en presente en Español: Tú mandoneas
Italian First Singular (B): Coniugazione del verbo disinfettare al presente in italiano: Io disinfetto
Italian Second Singular (B): Coniugazione del verbo disinfettare al presente in italiano: Tu disinfetti
German First Singular (B): Konjugation des Verbs annektieren im Präsens auf Deutsch: Ich annektiere
German Second Singular (B): Konjugation des Verbs annektieren im Präsens auf Deutsch: Du annektierst
English First Singular (B): Conjugation of the verb microtome in present tense in English: I microtome
English Second Singular (B): Conjugation of the verb microtome in present tense in English: You microtome
Spanish First Singular (D): mandonear: Nosotros mandoneamos. Tú mandoneas, Yo mandoneo
Spanish Second Singular (D): Conjugación del verbo mandonear en presente en Español: Nosotros mandoneamos. Yo mandoneo, Tú mandoneas
Italian First Singular (D): Coniugazione del verbo disinfettare al presente in italiano: Noi disinfettiamo. Tu disinfetti, Io disinfetto
Italian Second Singular (D): Coniugazione del verbo disinfettare al presente in italiano: Noi disinfettiamo. Io disinfetto, Tu disinfetti
German First Singular (D): Konjugation des Verbs annektieren im Präsens auf Deutsch: Wir annektieren. Du annektierst, Ich annektiere
German Second Singular (D): Konjugation des Verbs annektieren im Präsens auf Deutsch: Wir annektieren. Ich annektiere, Du annektierst
English First Singular (D): Conjugation of the verb microtome in present tense in English: We microtome. You microtome, I microtome
English Second Singular (D): Conjugation of the verb microtome in present tense in English: We microtome. I microtome, You microtome
Spanish First Singular (E): mandonear: Nosotros mandoneamos. Tú mandoneas, Yo mandoneo
Spanish Second Singular (E): mandonear: Nosotros mandoneamos. Yo mandoneo, Tú mandoneas
Italian First Singular (E): disinfettare: Noi disinfettiamo. Tu disinfetti, Io disinfetto
Italian Second Singular (E): disinfettare: Noi disinfettiamo. Io disinfetto, Tu disinfetti
German First Singular (E): annektieren: Wir annektieren. Du annektierst, Ich annektiere
German Second Singular (E): annektieren: Wir annektieren. Ich annektiere, Du annektierst
English First Singular (E): microtome: We microtome. You microtome, I microtome
English Second Singular (E): microtome: We microtome. I microtome, You microtome
